RO工具集/UI工具/1.0UI框架生成工具/Sort Comfs	Tools/UITool/Sort Comfs
RO工具集/UI工具/1.0UI框架生成工具/Export Template	Tools/UITool/Export Template
RO工具集/UI工具/GUI样式查看器	Tools/GUI样式查看器
RO工具集/UI工具/打开TextMeshPro组件查看窗口	Tools/ResTools/EnumTMP
RO工具集/UI工具/查询引用/查询引用	Tools/ResTools/查询引用
RO工具集/UI工具/查询引用/Find References In Project	ROTools/Finder/Find References In Project
RO工具集/UI工具/查询引用/Find References In Project	ROTools/Finder/Find References In Project
RO工具集/UI工具/查询引用/查找丢失的脚本	ROTools/Finder/查找丢失的脚本
RO工具集/UI工具/查询引用/查找脚本所有引用	ROTools/Finder/查找脚本所有引用
RO工具集/UI工具/Atlas Maker/Open Atlas Maker Custom	UITools/Open Atlas Maker Custom
RO工具集/UI工具/Atlas Maker/Batch Atlas Maker	UITools/Batch Atlas Maker
RO工具集/UI工具/Atlas Maker/Batch Atlas Maker Lit	UITools/Batch Atlas Maker
RO工具集/UI工具/脚本替换/Image换成RaycastImage	ROTools/UITools/RaycastImage replace
RO工具集/UI工具/脚本替换/指定文件Image换成RaycastImage	ROTools/UITools/RaycastImage replace select
RO工具集/UI工具/脚本替换/Mask换成RectMask2D	ROTools/UITools/Mask to rect mask 2d
RO工具集/UI工具/脚本替换/字体换成Common.TTF	ROTools/UITools/Arial to Common
RO工具集/UI工具/脚本替换/Scripts Replace	ROTools/UITools/Scripts Replace
RO工具集/UI工具/脚本替换/打开脚本替换窗口 (原Replace Script By GUID)	ROTools/Other/Replace Script By GUID
RO工具集/UI工具/UIAutoPosition &9	ROTools/UITools/UIAutoPosition &9
RO工具集/UI工具/UICompare	ROTools/UITools/UICompare
RO工具集/UI工具/字体/CustomFontMaker	ROTools/UITools/CustomFontMaker
RO工具集/UI工具/选中物体生成脚本文件/生成Lua文件 (原GenUIFromObj(Lua))	UITools/GenUIFromObj(Lua)
RO工具集/UI工具/选中物体生成脚本文件/生成C#文件 (原GenUIFromObj(C#))	UITools/GenUIFromObj(C#)
RO工具集/UI工具/选中物体生成脚本文件/选中目录下的prefab生成Lua文件 (原GenUIFromDir(Lua))	UITools/GenUIFromDir(Lua)
RO工具集/UI工具/快捷添加UI组件名后缀	UITools/后缀快捷添加
RO工具集/UI工具/生成UI文件路径(UIConst.lua)	UITools/导出UI文件路径(UIConst)
RO工具集/UI工具/Prefab Edit Window &W	ROTools/PrefabEditWindow &W
RO工具集/UI工具/打开材质贴图替换窗口 (原UIAtlasReplaceTools)	ROTools/Resource Tools/UIAtlasReplaceTools
RO工具集/UI工具/脚本替换/GraphicRaycaster换成MGraphicRaycaster (原Fresh Raycaster)	ROTools/FreshData/Fresh Raycaster
RO工具集/UI工具/5个Prefab刷新UIStringLocal	ROTools/FreshData/Fresh UI
RO工具集/UI工具/头像编辑/PrefabHead2DCheck	ROTools/HeadIconTools/PrefabHead2DCheck
RO工具集/UI工具/头像编辑/HeadIconEditor	ROTools/HeadIconTools/HeadIconEditor
RO工具集/UI工具/UIChecker/检查prefab引用图集 生成UICheck.txt	ROTools/UIChecker
RO工具集/UI工具/UIChecker/检测UI目录Prefab的DropdownEx组件是否为空	ROTools/检测Prefab的正确性
RO工具集/UI工具/脚本替换/批量替换prefab中组件	ROTools/批量替换prefab中组件
RO工具集/UI工具/查询引用/查找引用关系(artres文件夹)	Assets/查询引用/查找引用关系
RO工具集/UI工具/查询引用/查找引用关系(artres\\UI\\prefab文件夹) &Z	Assets/查询引用/查找在UI的prefab里的引用 &Z
RO工具集/UI工具/查询引用/选中物体Text组件为Bestfit，输出组件名字 &C	Assets/查询引用/查找Bestfit &C
RO工具集/UI工具/查询引用/查询图集失去引用的元素	Assets/查询引用/查询图集失去引用的元素
RO工具集/UI工具/查询引用/查询引用(整个工程)	Assets/ResTools/查询引用
RO工具集/UI工具/查询引用/查询引用(刷新选中物体依赖)	Assets/ResTools/查询引用(刷新部分索引)
RO工具集/UI工具/在当前目录下所有prefab添加FxOne组件	Assets/自动添加组件/在当前目录下所有prefab添加FxOne组件
RO工具集/UI工具/UGUI DrawCall小助手	GameObject/UGUI DrawCall小助手
RO工具集/UI工具/Set All Image NativeSize 	GameObject/SetAllImageNativeSize 
RO工具集/UI工具/打开RO1.5UI工具	GameObject/打开ROUI工具
RO工具集/UI工具/UI/UIMesh (原Mesh Image)	GameObject/UI/Mesh Image
RO工具集/UI工具/UI/AVPro Video uGUI	GameObject/UI/AVPro Video uGUI
RO工具集/UI工具/UI/Loop Horizontal Scroll Rect	GameObject/UI/Loop Horizontal Scroll Rect
RO工具集/UI工具/UI/Loop Vertical Scroll Rect	GameObject/UI/Loop Vertical Scroll Rect
RO工具集/动画特效工具/刷新比心拥抱亲吻动效	ROTools/FreshData/Fresh Double Anim
RO工具集/动画特效工具/刷新技能动效	ROTools/FreshData/Fresh Skill Anim
RO工具集/动画特效工具/刷新Story动效	ROTools/FreshData/Fresh Story Anim
RO工具集/动画特效工具/特效导出工具	Assets/FxTools/FxLodLevel
RO工具集/动画特效工具/特效导出工具	ROTools/FxTools/FxLodLevel
RO工具集/动画特效工具/统计特效Prefab写入FxNamePath	ROTools/FxTools/FxNamePath
RO工具集/动画特效工具/检查Animator的Mesh组件	ROTools/AnimationTools/CheckAnimatorMesh
RO工具集/动画特效工具/检查Animator的Avatar组件	ROTools/AnimationTools/CheckAnimator
RO工具集/动画特效工具/动画模型编辑/CreateAvatarMask #%&5	ROTools/ModelTools/CreateAvatarMask #%&5
RO工具集/动画特效工具/动画模型编辑/Extract Animation Clips(uncompressed)	ROTools/ModelTools/Extract Animation Clips(uncompressed)
RO工具集/动画特效工具/动画模型编辑/Extract Animation Clips #%&1	ROTools/ModelTools/Extract Animation Clips #%&1
RO工具集/动画特效工具/动画模型编辑/Create Animation Infos	ROTools/ModelTools/Create Animation Infos
RO工具集/动画特效工具/动画模型编辑/Extract HeadColorInfo &4	ROTools/ModelTools/Extract HeadColorInfo &4
RO工具集/动画特效工具/动画模型编辑/Tools Panel #%e	ROTools/ModelTools/Tools Panel #%e
RO工具集/动画特效工具/动画模型编辑/OptmizeAndExport #%&2	ROTools/ModelTools/OptmizeAndExport #%&2
RO工具集/动画特效工具/动画模型编辑/SaveSkinAsset #%&3	ROTools/ModelTools/SaveSkinAsset #%&3
RO工具集/动画特效工具/测试选中模型，用当前目录的动画进行测试 (原Create Animator Tester)	Assets/Create Animator Tester
RO工具集/动画特效工具/测试选中特效Overdraw	Assets/特效测试/测试选中特效
RO工具集/动画特效工具/摄像机看不见时停止动画播放 (原Fast Animator Culling)	Assets/Fast Animator Culling
RO工具集/动画特效工具/裁剪Animation Clip浮点数	Tools/裁剪Animation Clip浮点数
RO工具集/动画特效工具/裁剪Animation Clip浮点数 & 去除Scale	Tools/裁剪Animation Clip浮点数 & 去除Scale
RO工具集/贴图_Shader_材质_模型工具/图集处理/打开分离Alpha窗口 (原Texture Alpha Split) %#Q	Assets/ROTools/图集处理/Texture Alpha Split %#Q
RO工具集/贴图_Shader_材质_模型工具/图集处理/打开分离Alpha窗口 (原Texture Alpha Split) %#Q	ROTools/图集处理/Texture Alpha Split %#Q
RO工具集/贴图_Shader_材质_模型工具/图集处理/生成选中图集(_UI\\AtlasSource文件夹下图片再处理)	Assets/ROTools/图集处理/生成选中图集
RO工具集/贴图_Shader_材质_模型工具/图集处理/生成选中图集(_UI\\AtlasSource文件夹下图片再处理)	ROTools/图集处理/生成选中图集
RO工具集/贴图_Shader_材质_模型工具/图集处理/生成所有图集(_UI\\AtlasSource文件夹下图片再处理)	Assets/ROTools/图集处理/生成所有图集
RO工具集/贴图_Shader_材质_模型工具/图集处理/生成所有图集(_UI\\AtlasSource文件夹下图片再处理)	ROTools/图集处理/生成所有图集
RO工具集/贴图_Shader_材质_模型工具/图集处理/以图片的alpha值覆盖当前图片 (原Texture Alpha Convert)	Assets/ROTools/图集处理/Texture Alpha Convert
RO工具集/贴图_Shader_材质_模型工具/Export/Export all MeshFilters in selection to separate OBJs	Tools/Export/Export all MeshFilters in selection to separate OBJs
RO工具集/贴图_Shader_材质_模型工具/Export/Export each selected to single OBJ	Tools/Export/Export each selected to single OBJ
RO工具集/贴图_Shader_材质_模型工具/Export/Export whole selection to single OBJ	Tools/Export/Export whole selection to single OBJ
RO工具集/贴图_Shader_材质_模型工具/Shader_材质工具集合/雾DEBUG #%m	ROTools/Resource Tools/雾DEBUG #%m
RO工具集/贴图_Shader_材质_模型工具/Shader_材质工具集合/调整ShaderLOD #%.	ROTools/Resource Tools/调整ShaderLOD #%.
RO工具集/贴图_Shader_材质_模型工具/Shader_材质工具集合/快速设置环境 #%,	ROTools/Resource Tools/快速设置环境 #%,
RO工具集/贴图_Shader_材质_模型工具/Shader_材质工具集合/设置轮廓Tag #%t	ROTools/Resource Tools/设置轮廓Tag #%t
RO工具集/贴图_Shader_材质_模型工具/Shader_材质工具集合/批量格式处理工具	ROTools/Resource Tools/批量格式处理工具
RO工具集/贴图_Shader_材质_模型工具/Shader_材质工具集合/合批分组选择器	ROTools/Resource Tools/合批分组选择器
RO工具集/贴图_Shader_材质_模型工具/Shader_材质工具集合/查找shader使用关键字 #%k	ROTools/Resource Tools/查找shader使用关键字 #%k
RO工具集/贴图_Shader_材质_模型工具/Shader_材质工具集合/更新shaderKeyWord	ROTools/Resource Tools/更新shaderKeyWord
RO工具集/贴图_Shader_材质_模型工具/Shader_材质工具集合/获得当前场景资源内存占用量	ROTools/Resource Tools/获得当前场景资源内存占用量
RO工具集/贴图_Shader_材质_模型工具/Shader_材质工具集合/网格工具	ROTools/Resource Tools/网格工具
RO工具集/贴图_Shader_材质_模型工具/Shader_材质工具集合/重构光照贴图	ROTools/Resource Tools/重构光照贴图
RO工具集/贴图_Shader_材质_模型工具/Shader_材质工具集合/遮挡选择器 #%o	ROTools/Resource Tools/遮挡选择器 #%o
RO工具集/贴图_Shader_材质_模型工具/Shader_材质工具集合/纹理重构工具 #%`	ROTools/Resource Tools/纹理重构工具 #%`
RO工具集/贴图_Shader_材质_模型工具/Shader_材质工具集合/批量重命名 #%r	ROTools/Resource Tools/批量重命名 #%r
RO工具集/贴图_Shader_材质_模型工具/Shader_材质工具集合/资源检查工具 #%x	ROTools/Resource Tools/资源检查工具 #%x
RO工具集/贴图_Shader_材质_模型工具/Shader_材质工具集合/场景检查工具 #%q	ROTools/Resource Tools/场景检查工具 #%q
RO工具集/贴图_Shader_材质_模型工具/Shader_材质工具集合/天气数据工具 #%g	ROTools/Resource Tools/天气数据工具 #%g
RO工具集/贴图_Shader_材质_模型工具/Shader_材质工具集合/UI快捷替换 &E	Assets/Resource Tools/UI快捷替换 &E
RO工具集/贴图_Shader_材质_模型工具/Shader_材质工具集合/UI快捷替换 &E	ROTools/Resource Tools/UI快捷替换 &E
RO工具集/贴图_Shader_材质_模型工具/Shader_材质工具集合/UI快捷面板 #%v	ROTools/Resource Tools/UI快捷面板 #%v
RO工具集/贴图_Shader_材质_模型工具/Shader_材质工具集合/导出动画的临时动画文件	ROTools/Resource Tools/导出动画的临时动画文件
RO工具集/贴图_Shader_材质_模型工具/Shader_材质工具集合/检查UGUI射线 #%H	ROTools/Resource Tools/检查UGUI射线 #%H
RO工具集/贴图_Shader_材质_模型工具/生成柏林噪声	ROTools/Other/生成柏林噪声
RO工具集/贴图_Shader_材质_模型工具/TextureFormatSet/NPOT mipmap 检查工具	Assets/TextureFormatSet/TextureFormat 检查工具
RO工具集/贴图_Shader_材质_模型工具/TextureFormatSet/NPOT mipmap 检查工具	ROTools/TextureFormatSet/TextureFormat 检查工具
RO工具集/贴图_Shader_材质_模型工具/TextureFormatSet/RemoveTextureToIgnoreList(从忽略列表移除)	Assets/TextureFormatSet/RemoveTextureToIgnoreList(从忽略列表移除)
RO工具集/贴图_Shader_材质_模型工具/TextureFormatSet/RemoveTextureToIgnoreList(从忽略列表移除)	ROTools/TextureFormatSet/RemoveTextureToIgnoreList(从忽略列表移除)
RO工具集/贴图_Shader_材质_模型工具/TextureFormatSet/OneTextureFormatSet(设置选择贴图Format)	Assets/TextureFormatSet/OneTextureFormatSet(设置选择贴图Format)
RO工具集/贴图_Shader_材质_模型工具/TextureFormatSet/OneTextureFormatSet(设置选择贴图Format)	ROTools/TextureFormatSet/OneTextureFormatSet(设置选择贴图Format)
RO工具集/贴图_Shader_材质_模型工具/TextureFormatSet/DirectoryTextureFormatSet(设置文件夹下的所有贴图Format)	Assets/TextureFormatSet/DirectoryTextureFormatSet(设置文件夹下的所有贴图Format)
RO工具集/贴图_Shader_材质_模型工具/TextureFormatSet/DirectoryTextureFormatSet(设置文件夹下的所有贴图Format)	ROTools/TextureFormatSet/DirectoryTextureFormatSet(设置文件夹下的所有贴图Format)
RO工具集/贴图_Shader_材质_模型工具/TextureFormatSet/AllTextureFormatSet(全部设置)	Assets/TextureFormatSet/AllTextureFormatSet(全部设置)
RO工具集/贴图_Shader_材质_模型工具/TextureFormatSet/AllTextureFormatSet(全部设置)	ROTools/TextureFormatSet/AllTextureFormatSet(全部设置)
RO工具集/贴图_Shader_材质_模型工具/TextureFormatSet/AddTextureToIgnoreList(添加到忽略列表)	Assets/TextureFormatSet/AddTextureToIgnoreList(添加到忽略列表)
RO工具集/贴图_Shader_材质_模型工具/TextureFormatSet/AddTextureToIgnoreList(添加到忽略列表)	ROTools/TextureFormatSet/AddTextureToIgnoreList(添加到忽略列表)
RO工具集/贴图_Shader_材质_模型工具/Mesh Baker	Window/Mesh Baker
RO工具集/贴图_Shader_材质_模型工具/选中图片手动合批 (原Add To Particle Atlas)	Assets/Add To Particle Atlas
RO工具集/贴图_Shader_材质_模型工具/MeshTweaker/Rotate/Z90	Assets/MeshTweaker/Rotate/Z90
RO工具集/贴图_Shader_材质_模型工具/MeshTweaker/Rotate/Z45	Assets/MeshTweaker/Rotate/Z45
RO工具集/贴图_Shader_材质_模型工具/MeshTweaker/Rotate/Y90	Assets/MeshTweaker/Rotate/Y90
RO工具集/贴图_Shader_材质_模型工具/MeshTweaker/Rotate/Y45	Assets/MeshTweaker/Rotate/Y45
RO工具集/贴图_Shader_材质_模型工具/MeshTweaker/Rotate/X90	Assets/MeshTweaker/Rotate/X90
RO工具集/贴图_Shader_材质_模型工具/MeshTweaker/Rotate/X45	Assets/MeshTweaker/Rotate/X45
RO工具集/贴图_Shader_材质_模型工具/MeshTweaker/Align/Center	Assets/MeshTweaker/Align/Center
RO工具集/贴图_Shader_材质_模型工具/TexturePacker/Process to Prefabs	Assets/TexturePacker/Process to Prefabs
RO工具集/贴图_Shader_材质_模型工具/TexturePacker/Process to Meshes	Assets/TexturePacker/Process to Meshes
RO工具集/贴图_Shader_材质_模型工具/TexturePacker/Process to Sprites	Assets/TexturePacker/Process to Sprites
RO工具集/贴图_Shader_材质_模型工具/TexturePacker/Process to Sprites	Assets/TexturePacker/Process to Sprites
RO工具集/贴图_Shader_材质_模型工具/TexturePacker/Process to Prefabs	Assets/TexturePacker/Process to Prefabs
RO工具集/贴图_Shader_材质_模型工具/TexturePacker/Process to Meshes	Assets/TexturePacker/Process to Meshes
RO工具集/贴图_Shader_材质_模型工具/TexturePacker/Facing/Up	Assets/TexturePacker/Facing/Up
RO工具集/贴图_Shader_材质_模型工具/TexturePacker/Facing/Right	Assets/TexturePacker/Facing/Right
RO工具集/贴图_Shader_材质_模型工具/TexturePacker/Facing/Left	Assets/TexturePacker/Facing/Left
RO工具集/贴图_Shader_材质_模型工具/TexturePacker/Facing/Forward	Assets/TexturePacker/Facing/Forward
RO工具集/贴图_Shader_材质_模型工具/TexturePacker/Facing/Down	Assets/TexturePacker/Facing/Down
RO工具集/贴图_Shader_材质_模型工具/TexturePacker/Facing/Back	Assets/TexturePacker/Facing/Back
RO工具集/贴图_Shader_材质_模型工具/TexturePacker/Attach Shadow Mesh	Assets/TexturePacker/Attach Shadow Mesh
RO工具集/贴图_Shader_材质_模型工具/TexturePacker/Attach Shadow Mesh	Assets/TexturePacker/Attach Shadow Mesh
RO工具集/贴图_Shader_材质_模型工具/重新导入fbx (原Reimport all FBX)	Assets/Reimport all FBX
RO工具集/贴图_Shader_材质_模型工具/清理material中未用到的属性 (原Solve Materials)	Assets/Solve Materials
RO工具集/贴图_Shader_材质_模型工具/对shader文件加个数，批量重命名	Assets/Shader Version
RO工具集/贴图_Shader_材质_模型工具/图片处理工具 (原Texture Solver) #%b	Assets/Texture Solver #%b
RO工具集/贴图_Shader_材质_模型工具/选中模型的Mesh单独导出 (原Extract Mesh)	Assets/Extract Mesh
RO工具集/贴图_Shader_材质_模型工具/创建图集打包游戏物体ParticleAtlasAssembler (原Particle Atlas)	GameObject/Create Other/Particle Atlas
RO工具集/贴图_Shader_材质_模型工具/设置文件夹以及子文件夹下面的图片压缩格式为ASTC6x6	Assets/设置文件夹以及子文件夹下面的图片压缩格式为ASTC6x6
RO工具集/贴图_Shader_材质_模型工具/扫描所有Textures	Tools/扫描所有Textures
RO工具集/贴图_Shader_材质_模型工具/Open Texturelib Viewer (疑似废弃)	Tools/Open Texturelib Viewer
RO工具集/贴图_Shader_材质_模型工具/格式化所有Texture	Tools/格式化所有Texture
RO工具集/贴图_Shader_材质_模型工具/处理所有Model	Tools/处理所有Model
RO工具集/音效工具/UIFmodFastSetTools &T	Assets/Resource Tools/UIFmodFastSetTools &T
RO工具集/音效工具/UIFmodFastSetTools &T	ROTools/Resource Tools/UIFmodFastSetTools &T
RO工具集/音效工具/FMOD/将音频资源长度刷回表格	FMOD/将音频资源长度刷回表格
RO工具集/音效工具/FMOD/Node Camp	FMOD/Node Camp
RO工具集/音效工具/FMOD/Open Test Editor	FMOD/Open Test Editor
RO工具集/音效工具/FMOD/Migration From Legacy Integration	FMOD/Migration From Legacy Integration
RO工具集/音效工具/FMOD/Refresh Banks  (并刷新资源预览界面的缓存)	FMOD/Refresh Banks  (并刷新资源预览界面的缓存)
RO工具集/音效工具/FMOD/Help/Integration Manual	FMOD/Help/Integration Manual
RO工具集/音效工具/FMOD/Help/API Documentation	FMOD/Help/API Documentation
RO工具集/音效工具/FMOD/Help/Support Forum	FMOD/Help/Support Forum
RO工具集/音效工具/FMOD/Help/Revision History	FMOD/Help/Revision History
RO工具集/音效工具/FMOD/About Integration	FMOD/About Integration
RO工具集/音效工具/FMOD/Event Browser	FMOD/Event Browser
RO工具集/音效工具/FMOD/Find and Replace	FMOD/Find and Replace
RO工具集/音效工具/FMOD/Edit Settings	FMOD/Edit Settings
RO工具集/策划工具/SmallGames/获得百分比坐标 %&g	ROTools/SmallGames/获得百分比坐标 %&g
RO工具集/策划工具/SmallGames/屏幕坐标转anchoredpos %&h	ROTools/SmallGames/屏幕坐标转anchoredpos %&h
RO工具集/策划工具/SmallGames/小游戏配置工具	ROTools/SmallGames/小游戏配置工具
RO工具集/策划工具/表格工具/TaskTableColAdd	ROTools/TableTools/TaskTableColAdd
RO工具集/策划工具/表格工具/Reload All Table Data	ROTools/TableTools/Reload All Table Data
RO工具集/策划工具/表格工具/Clean All Table Data	ROTools/TableTools/Clean All Table Data
RO工具集/策划工具/表格工具/Table Dump/Server	ROTools/TableTools/Table Dump/Server
RO工具集/策划工具/表格工具/Table Dump/Editor	ROTools/TableTools/Table Dump/Editor
RO工具集/策划工具/表格工具/Table Dump/Client	ROTools/TableTools/Table Dump/Client
RO工具集/策划工具/表格工具/Refresh All Lua	ROTools/TableTools/Refresh All Lua
RO工具集/策划工具/表格工具/Open TableManager #&T	ROTools/TableTools/Open TableManager #&T
RO工具集/策划工具/表格工具/Table Exporter	ROTools/TableTools/Table Exporter
RO工具集/策划工具/任务编辑器/CutScene编辑器	ROTools/任务编辑器/CutScene编辑器
RO工具集/策划工具/任务编辑器/任务编辑器	ROTools/任务编辑器/表格编辑器
RO工具集/策划工具/任务编辑器/触发编辑器	ROTools/任务编辑器/触发编辑器
RO工具集/策划工具/任务编辑器/捏人编辑器->导出头像预览图	ROTools/任务编辑器/捏人编辑器->导出头像预览图
RO工具集/策划工具/任务编辑器/捏人编辑器->导出身体部件预览图	ROTools/任务编辑器/捏人编辑器->导出身体部件预览图
RO工具集/策划工具/任务编辑器/捏人编辑器	ROTools/任务编辑器/捏人编辑器
RO工具集/策划工具/[剧情图鉴]世界地图prefab信息导出	ROTools/Prefab信息导出/[剧情图鉴]世界地图prefab信息导出
RO工具集/策划工具/剧本工具	ROTools/剧本工具
RO工具集/策划工具/编辑弹幕	ROTools/编辑弹幕
RO工具集/策划工具/AlbertTableView	Window/AlbertTableView
RO工具集/策划工具/剧情预览	Window/剧情预览
RO工具集/策划工具/编辑剧情	Window/编辑剧情
RO工具集/策划工具/Generate Server Curve (Selected)	Assets/Generate Server Curve (Selected)
RO工具集/策划工具/Generate Server Curve (All)	Assets/Generate Server Curve (All)
RO工具集/策划工具/Generate Vehicle Path Curve	Assets/Generate Vehicle Path Curve
RO工具集/策划工具/生成C#	Assets/生成C#
RO工具集/第三方插件工具/Odin Inspector/Static Inspector	Tools/Odin Inspector/Static Inspector
RO工具集/第三方插件工具/Odin Inspector/Serialization Debugger	Tools/Odin Inspector/Serialization Debugger
RO工具集/第三方插件工具/Odin Inspector/Preferences	Tools/Odin Inspector/Preferences
RO工具集/第三方插件工具/Odin Inspector/Scene Validator (Deprecated)	Tools/Odin Inspector/Scene Validator (Deprecated)
RO工具集/第三方插件工具/Odin Inspector/Release Notes	Tools/Odin Inspector/Release Notes
RO工具集/第三方插件工具/Odin Inspector/Help/Report An Issue	Tools/Odin Inspector/Help/Report An Issue
RO工具集/第三方插件工具/Odin Inspector/Help/Discord	Tools/Odin Inspector/Help/Discord
RO工具集/第三方插件工具/Odin Inspector/Help/Contact	Tools/Odin Inspector/Help/Contact
RO工具集/第三方插件工具/Odin Inspector/Getting Started	Tools/Odin Inspector/Getting Started
RO工具集/第三方插件工具/Odin Inspector/Attribute Overview	Tools/Odin Inspector/Attribute Overview
RO工具集/第三方插件工具/Odin Inspector/About	Tools/Odin Inspector/About
RO工具集/第三方插件工具/Vertex Tools Pro/Vertex Tools Pro #%v	Tools/Vertex Tools Pro/Vertex Tools Pro #%v
RO工具集/第三方插件工具/Vertex Tools Pro/Vertex Color Animator #%a	Tools/Vertex Tools Pro/Vertex Color Animator #%a
RO工具集/第三方插件工具/Vertex Tools Pro/SpeedTree Painter (Early Access) #%t	Tools/Vertex Tools Pro/SpeedTree Painter (Early Access) #%t
RO工具集/第三方插件工具/EmmyLua/Generate Waper API	Tools/EmmyLua/Generate Waper API
RO工具集/第三方插件工具/Simplygon/Login	Tools/Simplygon/Login
RO工具集/第三方插件工具/Odin Serializer/Refresh Assembly Import Settings	Tools/Odin Serializer/Refresh Assembly Import Settings
RO工具集/第三方插件工具/Overdraw Tool	Tools/Overdraw Tool
RO工具集/第三方插件工具/Behavior Designer/Editor	Tools/Behavior Designer/Editor
RO工具集/第三方插件工具/Behavior Designer/Global Variables	Tools/Behavior Designer/Global Variables
RO工具集/第三方插件工具/Behavior Designer/Error List	Tools/Behavior Designer/Error List
RO工具集/第三方插件工具/Behavior Designer/Welcome Screen	Tools/Behavior Designer/Welcome Screen
RO工具集/第三方插件工具/Behavior Designer/导出AI节点C++	ROTools/BehaivorTools/导出AI节点C++
RO工具集/第三方插件工具/Behavior Designer/导出AI节点C#	ROTools/BehaivorTools/导出AI节点C#
RO工具集/第三方插件工具/Behavior Designer/行为树属性转换	ROTools/BehaivorTools/行为树属性转换
RO工具集/第三方插件工具/Behavior Designer/批量修改行为树变量类型	ROTools/BehaivorTools/批量修改行为树变量类型
RO工具集/第三方插件工具/Behavior Designer/导出行为树文件（服务器）	ROTools/BehaivorTools/导出行为树文件（服务器）
RO工具集/第三方插件工具/Behavior Designer/导出行为树PB文件（客户端）	ROTools/BehaivorTools/导出行为树PB文件（客户端）
RO工具集/第三方插件工具/Cinemachine/Create Virtual Camera	Cinemachine/Create Virtual Camera
RO工具集/第三方插件工具/Cinemachine/Create Target Group Camera	Cinemachine/Create Target Group Camera
RO工具集/第三方插件工具/Cinemachine/Create State-Driven Camera	Cinemachine/Create State-Driven Camera
RO工具集/第三方插件工具/Cinemachine/Create Mixing Camera	Cinemachine/Create Mixing Camera
RO工具集/第三方插件工具/Cinemachine/Create FreeLook Camera	Cinemachine/Create FreeLook Camera
RO工具集/第三方插件工具/Cinemachine/Create Dolly Track with Cart	Cinemachine/Create Dolly Track with Cart
RO工具集/第三方插件工具/Cinemachine/Create Dolly Camera with Track	Cinemachine/Create Dolly Camera with Track
RO工具集/第三方插件工具/Cinemachine/Create ClearShot Camera	Cinemachine/Create ClearShot Camera
RO工具集/第三方插件工具/Cinemachine/Create Blend List Camera	Cinemachine/Create Blend List Camera
RO工具集/第三方插件工具/Cinemachine/Create 2D Camera	Cinemachine/Create 2D Camera
RO工具集/第三方插件工具/Cinemachine/About	Cinemachine/About
RO工具集/第三方插件工具/T4M Source Codes %t	Window/T4M Source Codes %t
RO工具集/第三方插件工具/Panorama To Cubemap	Window/Panorama To Cubemap
RO工具集/第三方插件工具/AVPro Video Support	Window/AVPro Video Support
RO工具集/第三方插件工具/BehaviorTools/导出当前选择的行为树的PB文件（客户端）	Assets/BehaviorTools/导出当前选择的行为树的PB文件（客户端）
RO工具集/第三方插件工具/BehaviorTools/导出当前选择的行为树（服务器）	Assets/BehaviorTools/导出当前选择的行为树（服务器）
RO工具集/第三方插件工具/BehaviorTools/导出行为树至其他地区/香港	Assets/BehaviorTools/导出行为树至其他地区/香港
RO工具集/第三方插件工具/BehaviorTools/导出行为树至其他地区/韩国	Assets/BehaviorTools/导出行为树至其他地区/韩国
RO工具集/第三方插件工具/BehaviorTools/导出行为树至其他地区/日本	Assets/BehaviorTools/导出行为树至其他地区/日本
RO工具集/第三方插件工具/BehaviorTools/导出行为树至其他地区/北美	Assets/BehaviorTools/导出行为树至其他地区/北美
RO工具集/第三方插件工具/Mesh Baker/Batch Prefab Baker	GameObject/Create Other/Mesh Baker/Batch Prefab Baker
RO工具集/第三方插件工具/Mesh Baker/Bone Weight Copier	GameObject/Create Other/Mesh Baker/Bone Weight Copier
RO工具集/第三方插件工具/Mesh Baker/TextureBaker and MeshBaker	GameObject/Create Other/Mesh Baker/TextureBaker and MeshBaker
RO工具集/第三方插件工具/Mesh Baker/MeshBaker	GameObject/Create Other/Mesh Baker/MeshBaker
RO工具集/第三方插件工具/Mesh Baker/TextureBaker and MultiMeshBaker	GameObject/Create Other/Mesh Baker/TextureBaker and MultiMeshBaker
RO工具集/第三方插件工具/Mesh Baker/TextureBaker	GameObject/Create Other/Mesh Baker/TextureBaker
RO工具集/第三方插件工具/UnlitWater/Create UnlitWater	GameObject/UnlitWater/Create UnlitWater
RO工具集/第三方插件工具/ProGrids/Nudge Perspective Backward	Tools/ProGrids/Nudge Perspective Backward
RO工具集/第三方插件工具/ProGrids/Nudge Perspective Forward	Tools/ProGrids/Nudge Perspective Forward
RO工具集/第三方插件工具/ProGrids/Reset Perspective Nudge	Tools/ProGrids/Reset Perspective Nudge
RO工具集/第三方插件工具/ProGrids/Reset Perspective Nudge	Tools/ProGrids/Reset Perspective Nudge
RO工具集/第三方插件工具/ProGrids/ProGrids Window	Tools/ProGrids/ProGrids Window
RO工具集/第三方插件工具/ProGrids/Nudge Perspective Forward	Tools/ProGrids/Nudge Perspective Forward
RO工具集/第三方插件工具/ProGrids/Nudge Perspective Backward	Tools/ProGrids/Nudge Perspective Backward
RO工具集/第三方插件工具/ProGrids/Cycle SceneView Projection	Tools/ProGrids/Cycle SceneView Projection
RO工具集/第三方插件工具/ProGrids/Increase Grid Size	Tools/ProGrids/Increase Grid Size
RO工具集/第三方插件工具/ProGrids/Decrease Grid Size	Tools/ProGrids/Decrease Grid Size
RO工具集/第三方插件工具/ProGrids/Increase Grid Size	Tools/ProGrids/Increase Grid Size
RO工具集/第三方插件工具/ProGrids/Decrease Grid Size	Tools/ProGrids/Decrease Grid Size
RO工具集/第三方插件工具/ProGrids/Cycle SceneView Projection	Tools/ProGrids/Cycle SceneView Projection
RO工具集/第三方插件工具/ProGrids/Close ProGrids	Tools/ProGrids/Close ProGrids
RO工具集/第三方插件工具/ProGrids/Close ProGrids	Tools/ProGrids/Close ProGrids
RO工具集/第三方插件工具/ProGrids/About	Tools/ProGrids/About
RO工具集/AssetBundle工具/RoabInfoTool	Tools/ResTools/RoabInfoTool
RO工具集/AssetBundle工具/ABTools/检查AB冗余	ROTools/ABTools/检查AB冗余
RO工具集/AssetBundle工具/ABTools/Encrypt AB	ROTools/ABTools/Encrypt AB
RO工具集/AssetBundle工具/ABTools/Builder Panel &0	ROTools/ABTools/Builder Panel &0
RO工具集/AssetBundle工具/ABTools/AssetBundle Detail	ROTools/ABTools/AssetBundle Detail
RO工具集/AssetBundle工具/ABTools/XBuild/XBuildEditor	ROTools/ABTools/XBuild/XBuildEditor
RO工具集/AssetBundle工具/PC包/编译PC包DLL(需要配置msbuild+代码权限)	ROTools/ABTools/PC包/编译PC包DLL(需要配置msbuild+代码权限)
RO工具集/AssetBundle工具/PC包/打PC包+编译dll(需要配置msbuild+代码权限)	ROTools/ABTools/PC包/打PC包+编译dll(需要配置msbuild+代码权限)
RO工具集/AssetBundle工具/PC包/打PC包	ROTools/ABTools/PC包/打PC包
RO工具集/AssetBundle工具/ABTools/Enable Run With Dll	ROTools/ABTools/Enable Run With Dll
RO工具集/AssetBundle工具/ABTools/Build IOS	ROTools/ABTools/Build IOS
RO工具集/AssetBundle工具/ABTools/Build Android	ROTools/ABTools/Build Android
Lua/LuaTools/Lua Coverage	LuaTools/Lua Coverage
Lua/LuaTools/LuaFast 便捷测试	LuaTools/LuaFast 便捷测试
Lua/LuaTools/Lua Profiler/Attach Lua Profiler	LuaTools/Lua Profiler/Attach Lua Profiler
Lua/LuaTools/Lua Profiler/Detach Lua Profiler	LuaTools/Lua Profiler/Detach Lua Profiler
Lua/LuaTools/Lua Memory Tools/Snap Memory	LuaTools/Lua Memory Tools/Snap Memory
Lua/lua 脚本加密/EncryLuaZip	ROTools/LuaTools/EncryLuaZip
Lua/lua 脚本加密/EncryLuaFileAndSendToMuMu	ROTools/LuaTools/EncryLuaFileAndSendToMuMu
Lua/lua 脚本加密/EncryLuaFile	ROTools/LuaTools/EncryLuaFile
Lua/lua 脚本加密/TestLuaTool	ROTools/LuaTools/TestLuaTool
Lua/Lua Profiler Window	Window/Lua Profiler Window
RO工具集/本地化工具/本地化资源移动 (原MoveLangRes)	Assets/ROTools/Localization/移动资源到语言目录
RO工具集/本地化工具/本地化资源移动 (原MoveLangRes)	ROTools/Localization/语言资源工具（移动资源）
RO工具集/本地化工具/编辑器预览海外资源	ROTools/Localization/预览当前地区资源
RO工具集/本地化工具/本地化文本工具	ROTools/Localization/本地化文本工具
RO工具集/本地化工具/切换到日本	ROTools/Localization/切换到日本
RO工具集/本地化工具/切换到日本	ROTools/Localization/切换到日本
RO工具集/本地化工具/切换到港澳台	ROTools/Localization/切换到港澳台
RO工具集/本地化工具/切换到港澳台	ROTools/Localization/切换到港澳台
RO工具集/本地化工具/切换到韩国	ROTools/Localization/切换到韩国
RO工具集/本地化工具/切换到韩国	ROTools/Localization/切换到韩国
RO工具集/本地化工具/切换到北美	ROTools/Localization/切换到北美
RO工具集/本地化工具/切换到北美	ROTools/Localization/切换到北美
RO工具集/本地化工具/切换到中国	ROTools/Localization/切换到中国
RO工具集/本地化工具/切换到中国	ROTools/Localization/切换到中国
RO工具集/本地化工具/Helper/替换Lua代码中的所有字符占位符	ROTools/Localization/Helper/将Lua代码中的所有字符占位符
RO工具集/本地化工具/Helper/Create LangResConfig	ROTools/Localization/Helper/Create LangResConfig
RO工具集/本地化工具/打开翻译流程工具	ROTools/Localization/打开翻译流程工具
RO工具集/本地化工具/Helper/批量刷Atlas&Texture本地化组件（定向到中文）	ROTools/Localization/Helper/批量刷Atlas&Texture本地化组件（定向到中文）
RO工具集/本地化工具/Helper/Create Font Asset	ROTools/Localization/Helper/Create Font Asset
RO工具集/本地化工具/[测试用]DebugTool	ROTools/Localization/[测试用]DebugTool
战斗编辑工具/Neo 编辑器/打开技能编辑器	Neo编辑器/打开技能编辑器
战斗编辑工具/Neo 编辑器/打开数据编辑器	Neo编辑器/打开数据编辑器
战斗编辑工具/SkillTools/Select Hoster #`	ROTools/SkillTools/Select Hoster #`
战斗编辑工具/SkillTools/GotoBandpose or Back to anim #F1	ROTools/SkillTools/GotoBandpose or Back to anim #F1
战斗编辑工具/SkillTools/Generate All Bytes	ROTools/SkillTools/Generate All Bytes
战斗编辑工具/SkillTools/Copy Male To Female %&i	ROTools/SkillTools/Copy Male To Female %&i
战斗编辑工具/SkillTools/Create Skill %i	ROTools/SkillTools/Create Skill %i
战斗编辑工具/SkillTools/MSkillFxCg &x	Window/SkillTools/MSkillFxCg &x
战斗编辑工具/SkillTools/Create Curve	Assets/ROTools/SkillTools/Create Curve
战斗编辑工具/SkillTools/Create Color SkillRim	Assets/ROTools/SkillTools/Create Color SkillRim
战斗编辑工具/SkillTools/Create Color Palette	Assets/ROTools/SkillTools/Create Color Palette
战斗编辑工具/场景工具/ProcessCurSceneLODGroup	Tools/ProcessCurSceneLODGroup
战斗编辑工具/场景工具/SimpleLOD	Tools/SimpleLOD
战斗编辑工具/场景工具/SimpleLOD	Tools/SimpleLOD
战斗编辑工具/场景工具/SceneTools/SaveActiveSceneSVC	ROTools/SceneTools/SaveActiveSceneSVC
战斗编辑工具/场景工具/SceneTools/整理场景中触发器数据	ROTools/SceneTools/整理场景中触发器数据
战斗编辑工具/场景工具/SceneTools/快速创建改变视角碰撞体 #x	ROTools/SceneTools/快速创建改变视角碰撞体 #x
战斗编辑工具/场景工具/SceneTools/批量发布设置运行时场景	ROTools/SceneTools/批量发布设置运行时场景
战斗编辑工具/场景工具/SceneTools/批量发布设置美术编辑场景	ROTools/SceneTools/批量发布设置美术编辑场景
战斗编辑工具/场景工具/SceneTools/HeightMapEditor	ROTools/SceneTools/HeightMapEditor
战斗编辑工具/场景工具/SceneTools/Map Editor	ROTools/SceneTools/Map Editor
战斗编辑工具/场景工具/SceneTools/Rush SceneEditor Xml	ROTools/SceneTools/Rush SceneEditor Xml
战斗编辑工具/场景工具/SceneTools/Rush SceneEditor Xml By SceneTable	ROTools/SceneTools/Rush SceneEditor Xml By SceneTable
战斗编辑工具/场景工具/SceneTools/BakePanel  #%&B	BakePanel  #%&B
战斗编辑工具/场景工具/SceneTools/Load #%;	ROTools/SceneTools/Load #%;
战斗编辑工具/场景工具/SceneTools/TerrianEditor	ROTools/SceneTools/TerrianEditor
战斗编辑工具/场景工具/SceneTools/生成场景预制体	ROTools/SceneTools/生成场景预制体
战斗编辑工具/场景工具/SceneTools/GrassEditor	ROTools/SceneTools/GrassEditor
战斗编辑工具/场景工具/SceneTools/TriangleCount	ROTools/SceneTools/TriangleCount
战斗编辑工具/场景工具/SceneTools/刷新场景到EditorBuildSetting	ROTools/SceneTools/刷新场景到EditorBuildSetting
战斗编辑工具/场景工具/SceneTools/Pause %x	ROTools/SceneTools/Pause %x
战斗编辑工具/场景工具/切换场景/Open Pre Scene %&g	ROTools/Other/Open Pre Scene %&g
战斗编辑工具/场景工具/切换场景/Open Game Scene %g	ROTools/Other/Open Game Scene %g
战斗编辑工具/场景工具/Fresh Scene Prefab生成bytes	ROTools/FreshData/Fresh Scene Prefab
战斗编辑工具/场景工具/各场景NPC波利信息	ROTools/BoliGroupPosTool
战斗编辑工具/场景工具/OpenSceneEditor	ROTools/OpenSceneEditor
战斗编辑工具/场景工具/任务镜头参数工具	Window/任务镜头参数工具
战斗编辑工具/场景工具/SceneTriggerObject/添加球形触发器对象	Window/SceneTriggerObject/添加球形触发器对象
战斗编辑工具/场景工具/SceneTriggerObject/添加方块形触发器对象	Window/SceneTriggerObject/添加方块形触发器对象
战斗编辑工具/场景工具/SceneSelectionFilter	Window/SceneSelectionFilter
战斗编辑工具/场景工具/带值拷贝	GameObject/带值拷贝
战斗编辑工具/场景工具/Update Scene with Prefab Lightmaps	Assets/Update Scene with Prefab Lightmaps
战斗编辑工具/场景工具/Bake Prefab Lightmaps	Assets/Bake Prefab Lightmaps
战斗编辑工具/场景工具/AutoLOD/Remove LODs	Assets/AutoLOD/Remove LODs
战斗编辑工具/场景工具/AutoLOD/Remove LODs	Assets/AutoLOD/Remove LODs
战斗编辑工具/场景工具/AutoLOD/Generate LOD	Assets/AutoLOD/Generate LOD
战斗编辑工具/场景工具/AutoLOD/Generate LOD	Assets/AutoLOD/Generate LOD
战斗编辑工具/场景工具/SceneEditor/将此对象设置为模板	GameObject/SceneEditor/将此对象设置为模板
战斗编辑工具/场景工具/SceneEditor/添加一个模板项	GameObject/SceneEditor/添加一个模板项
战斗编辑工具/场景工具/Auto Light Probe Group	GameObject/Auto Light Probe Group
战斗编辑工具/场景工具/场景节点按材质->网格方式重命名及排序	GameObject/场景节点按材质->网格方式重命名及排序
战斗编辑工具/场景工具/Light Beam	GameObject/Create Other/Light Beam
战斗编辑工具/场景工具/场景交互物件	GameObject/SceneTool/场景交互物件
战斗编辑工具/场景工具/AutoLOD/Remove Children LODGroups	GameObject/AutoLOD/Remove Children LODGroups
战斗编辑工具/场景工具/AutoLOD/Generate LODs (Prefabs and Scene GameObjects)	GameObject/AutoLOD/Generate LODs (Prefabs and Scene GameObjects)
战斗编辑工具/场景工具/AutoLOD/Generate LODs (Prefabs and Scene GameObjects)	GameObject/AutoLOD/Generate LODs (Prefabs and Scene GameObjects)
战斗编辑工具/场景工具/AutoLOD/Grid Placement Utility	GameObject/AutoLOD/Grid Placement Utility
RO工具集/其他工具/ClearProgressBar	Tools/ClearProgressBar
RO工具集/其他工具/StatisticAllResources	Tools/ResTools/ResStatistic
RO工具集/其他工具/Hotfix Tools/Config Editor	ROTools/Hotfix Tools/Config Editor
RO工具集/其他工具/Hotfix Tools/Sign MPlatformConfig	ROTools/Hotfix Tools/Sign MPlatformConfig
RO工具集/其他工具/拍照点记录工具	ROTools/Other/拍照点记录工具
RO工具集/其他工具/防剔除文件生成 #%F12	ROTools/Other/防剔除文件生成 #%F12
RO工具集/其他工具/Hierarchy窗口设置/窗口中物体右侧关闭勾选框 (原GameObject Active Toggle Close)	ROTools/HierarchySet/GameObject Active Toggle Close
RO工具集/其他工具/Hierarchy窗口设置/窗口中物体右侧开启勾选框 (原GameObject Active Toggle Open)	ROTools/HierarchySet/GameObject Active Toggle Open
RO工具集/其他工具/Open UUIDObjectPool Debugger	ROTools/Debugger/Open UUIDObjectPool Debugger
RO工具集/其他工具/导航工具/导航数据生成工具	ROTools/PathTools/导航数据生成工具
RO工具集/其他工具/Emoji工具/Build Emoji	ROTools/Emoji Tools/Build Emoji
RO工具集/其他工具/废资源检查/分析资源空间占比	ROTools/废资源检查/分析资源空间占比
RO工具集/其他工具/废资源检查/删除没用的文件	ROTools/废资源检查/删除没用的文件
RO工具集/其他工具/废资源检查/检查动画	ROTools/废资源检查/检查动画
RO工具集/其他工具/废资源检查/检查特效	ROTools/废资源检查/检查特效
RO工具集/其他工具/废资源检查/检查模型	ROTools/废资源检查/检查模型
RO工具集/其他工具/废资源检查/检查小地图	ROTools/废资源检查/检查小地图
RO工具集/其他工具/废资源检查/检查场景	ROTools/废资源检查/检查场景
RO工具集/其他工具/Theater/创建 MTheaterCameraAsset Asset	ROTools/Theater/Create Asset
RO工具集/其他工具/清除本地数据/清除所有	ROTools/清除本地数据/清除所有
RO工具集/其他工具/清除本地数据/清除首包解压标记	ROTools/清除本地数据/清除首包解压标记
RO工具集/其他工具/卸载rocommongamelibs.dll	ROTools/卸载rocommongamelibs.dll
RO工具集/其他工具/设置周年庆测试账号	ROTools/设置周年庆测试账号
RO工具集/其他工具/Export Preload Paths to preload.txt	ROTools/Export Preload Paths
RO工具集/其他工具/场景、技能数据 protobuffer转xml (原PbEditor)	ROTools/PbEditor
RO工具集/其他工具/Reporter/创建物体添加Reporter脚本 配合Lua脚本记录日志 (原Create)	Reporter/Create
RO工具集/其他工具/MemoryProfiler	Window/MemoryProfiler
RO工具集/其他工具/MemoryProfilerInspect	Window/MemoryProfilerInspect
RO工具集/其他工具/资源快速调整/选出有丢失材质或纹理的预设	Assets/资源快速调整/选出有丢失材质或纹理的预设
RO工具集/其他工具/资源快速调整/所选动画组件规范设置	Assets/资源快速调整/所选动画组件规范设置
RO工具集/其他工具/资源快速调整/当前目录下所有可调整资源	Assets/资源快速调整/当前目录下所有可调整资源
RO工具集/其他工具/资源快速调整/处理预设	Assets/资源快速调整/处理预设
RO工具集/其他工具/资源快速调整/处理纹理	Assets/资源快速调整/处理纹理
RO工具集/其他工具/资源快速调整/处理特效	Assets/资源快速调整/处理特效
RO工具集/其他工具/资源快速调整/处理模型	Assets/资源快速调整/处理模型
RO工具集/其他工具/资源快速调整/处理材质	Assets/资源快速调整/处理材质
RO工具集/其他工具/资源快速调整/处理动画	Assets/资源快速调整/处理动画
RO工具集/其他工具/资源快速调整/一键处理特效	Assets/资源快速调整/一键处理特效
RO工具集/其他工具/资源快速调整/一键处理挂件	Assets/资源快速调整/一键处理挂件
RO工具集/其他工具/资源快速调整/一键处理场景	Assets/资源快速调整/一键处理场景
RO工具集/其他工具/资源快速调整/修改MLuaUIGroup ClassName	Assets/资源快速调整/修改MLuaUIGroup ClassName
RO工具集/其他工具/导出/选中的assets文件写成Json数据	Assets/导出/Json数据
RO工具集/其他工具/导出/选中的assets文件写成Binary数据	Assets/导出/Binary数据
RO工具集/其他工具/编译/触发器	Assets/编译/触发器
RO工具集/其他工具/编译/数据文件	Assets/编译/数据文件
RO工具集/其他工具/编译/AI	Assets/编译/AI
RO工具集/其他工具/选中物体然后反选含有_bandpose的物体	Assets/Select All Model Without BindPose In Folder
RO工具集/其他工具/保存所有资源 (原SaveAllAsset)	Assets/SaveAsset
RO工具集/其他工具/Unload Unused Assets	GameObject/Clean
RO工具集/其他工具/创建物体ClimbMesh (原Climbing Zone)	GameObject/Climbing Zone
RO工具集/其他工具/Align View to Selected (hotkey) #&f	GameObject/Align View to Selected (hotkey) #&f
RO工具集/其他工具/GPU Skinning/Create Vertex Anim Mesh	Assets/GPU Skinning/Create Vertex Anim Mesh
RO工具集/其他工具/GPU Skinning/Create GPU Skinning Mesh	Assets/GPU Skinning/Create GPU Skinning Mesh
RO工具集/其他工具/创建AssetRule ScriptableObject (原Create Asset Auditing Rule)	Assets/Create Asset Auditing Rule
RO工具集/其他工具/创建AssetPolicy ScriptableObject (原Create Asset Policy)	Assets/Create Asset Policy
